W,W,W,W,W,W,W,W,W,W,W,W,W,W,W,W,W,W,W,
W,1,,,,,,,,,,,,,,,,,W,
W,,,,,,,,,,,,,,,,,,W,
W,,,,,,,,,,,,,,,,,,W,
W,,,,,,,,,,,,,,,,,,W,
W,,,,,,,,,,,,,,,,,,W,
W,,,,,,,,,,,,,,,,,,W,
W,,,,,,,,,,,,,,,,,,W,
W,,,,,,,,,,,,,,,,,,W,
W,,,,,,,,,,,,,,,,,,W,
W,,,,,,,,,,,,,,,,,,W,
W,,,,,,,,,,,,,,,,,,W,
W,,,,,,,,,,,,,,,,,,W,
W,,,,,,,,,,,,,,,,,,W,
W,,,,,,,,,,,,,,,,,,W,
W,,,,,,,,,,,,,,,,,,W,
W,,,,,,,,,,,,,,,,,,W,
W,,,,,,,,,,,,,,,,,,W,
W,,,,,,,,,,,,,,,,,,W,
W,W,W,W,W,W,W,W,W,W,W,W,W,W,W,W,W,W,W,
