W,W,W,W,W,W,W,W,W,W,W,W,W,W,W,W,W,W,W,W,W,W,W,W,W,W,W,W,W,W,W,W,W
W,,,,W,,,,,,W,,W,,W,,W,,W,,W,,W,,,,,,,,W,,W
W,W,W,,W,,W,W,W,,W,W,W,W,W,W,W,W,W,W,W,W,W,,W,W,W,W,W,,W,W,W
W,,W,,,,W,,,,W,,W,,W,,W,,W,,W,,W,,,,W,,,,W,,W
W,,W,W,W,W,W,,W,W,W,W,W,W,W,W,W,W,W,W,W,W,W,W,W,,W,,W,W,W,W,W
W,,,,,,,,W,,,,W,,W,,W,,W,,W,,W,,,,W,,,,W,,W
W,,W,W,W,W,W,W,W,,W,,W,W,W,W,W,W,W,W,W,W,W,,W,W,W,W,W,,W,W,W
W,,W,,W,,,,W,,W,,,,,,,,,,W,,,,W,,W,,,,W,,W
W,,W,,W,,W,,W,,W,W,W,W,W,W,W,W,W,,W,,W,W,W,,W,,W,W,W,W,W
W,,W,,W,,W,,W,,W,,,,,,W,,,,W,,,,W,,W,,W,,W,,W
W,,W,,W,,W,,W,,W,,W,W,W,,W,,W,W,W,W,W,,W,,W,,W,W,W,W,W
W,,W,,,,W,,W,,,,W,,W,,W,,,,W,,W,,,,W,,,,,,W
W,,W,W,W,W,W,,W,W,W,W,W,W,W,,W,W,W,,W,W,W,W,W,,W,W,W,W,W,,W
W,,,,W,,,,W,,,,,,,,W,,W,,,,,,,,W,,W,,,,W
W,W,W,,W,,W,,W,,W,W,W,W,W,W,W,W,W,W,W,W,W,W,W,W,W,W,W,,W,,W
W,,,,W,,W,,W,,W,,,,W,,W,,W,,W,,W,,W,,W,,,,W,,W
W,,W,W,W,,W,W,W,,W,,W,,W,W,W,W,W,W,W,W,W,W,W,W,W,,W,W,W,W,W
W,,,,W,,,,,,W,,W,,,,W,,W,,W,,W,,W,,W,,,,,,W
W,W,W,,W,W,W,,W,W,W,,W,W,W,,W,W,W,W,W,W,W,W,W,W,W,W,W,W,W,,W
W,,W,,,,W,,,,,,W,,,,W,,W,,W,,W,,W,,W,,W,,W,,W
W,,W,W,W,,W,W,W,W,W,W,W,,W,W,W,W,W,W,W,W,W,W,W,W,W,W,W,W,W,,W
W,,,,,,W,,W,,W,,,,W,,W,,W,,W,,W,,W,,W,,W,,W,,W
W,,W,W,W,W,W,W,W,W,W,,W,W,W,W,W,W,W,W,W,W,W,W,W,W,W,W,W,W,W,,W
W,,,,,,,,W,,W,C,W,,W,,,,W,,W,,W,,W,,W,,W,,W,,W
W,W,W,W,W,W,W,,W,W,W,W,W,W,W,,W,,W,W,W,W,W,W,W,W,W,W,W,W,W,,W
W,,W,,W,,W,,,,W,,W,,W,,W,,W,,W,,W,,W,,W,,W,,W,,W
W,W,W,W,W,W,W,W,W,,W,W,W,W,W,,W,,W,W,W,W,W,W,W,W,W,W,W,W,W,,W
W,,W,,W,,W,,W,,W,,W,,,,W,,W,,W,,W,,W,,W,,W,,W,,W
W,W,W,W,W,W,W,W,W,,W,W,W,,W,W,W,,W,W,W,W,W,W,W,W,W,W,W,W,W,,W
W,,W,,W,,W,,W,,W,,W,,,,W,,W,,W,,W,,W,,W,,W,,W,,W
W,W,W,W,W,W,W,W,W,,W,W,W,W,W,,W,,W,W,W,W,W,W,W,W,W,W,W,W,W,,W
W,,W,,W,,W,,W,,,,,,,,W,,,,,,,,,,,,,,,,W
W,W,W,W,W,W,W,W,W,W,W,W,W,W,W,W,W,W,W,W,W,W,W,W,W,W,W,W,W,W,W,W,W
